NO textures/north.xpm
SO textures/south.xpm
WE textures/west.xpm
EA textures/east.xpm

F 20,20,20
C 200,200,200


11111
10101
11N11
10101
11111