NO textures/wolfenstein/grey_stone.xpm
SO textures/wolfenstein/purple_stone.xpm
WE textures/wolfenstein/red_brick.xpm
EA textures/wolfenstein/wood.xpm

F 18,53,25
C 63,22,71

111111111111
1         11
1       0001
1000000 0011
10N000000001
111111111111
11         1
