NO textures/north.xpm
SO textures/south.xpm
WE textures/west.xpm
EA textures/east.xpm

F 20,20, 0
C 200,200,0

11111
10001
10S01
10001
10001
10001
11001
10001
10001
10001
10001
10001
11D11
